#.........
..........
..####....
..........
..........
...#......
...#......
..........
......###.
..........
