...#......
...#......
...#......
..........
#.........
..........
....###...
..........
..........
.....#....
